+---+---+---+---+---+---+
                        |
+---+---+---+   +---+   +
|                   |   |
+   +---+   +---+---+   +
|       |           |   |
+   +---+   +---+   +   +
|   |       |       |   |
+   +   +   +---+   +   +
|   |   |   |       |   |
+   +---+---+---+---+   +
|       |                
+---+---+---+---+---+---+

